1111111111111111
1PCCCC0000000001
1010101000011111
100000000001C0C1
1000000011010101
1000001010010101
1000000000010001
11E0000000001011
1000000011110101
1000000010100111
1C10000000011111
1111111000101111
1000000000000001
1000001100000001
1000111111000001
1000000000011001
1111111111111111
1111111111111111