1111111111111111
1PCCCC0000000001
1010101000011111
100000000001C0C1
1000000011010101
1000001010010101
100000C000010001
11E000C000000011
100000C011110101
100000C010100111
1C1000C000011111
1111111000101111
1000000000000001
10000011CC000001
1000111111000001
1000000000011001
1111111111111111
1111111111111111