1111111111111111111111111111111111
100CC1000000400000C000000040000001
100401000C000010100100C00111111111
101111000000030010000004010000C111
100000004000001000000000000C000001
1111111111111110001111111111111111
1000000000003000000000040001111111
10100101001000001C1001000031111111
1010C1001E101010001001111100411111
1C0000400001C00010004000000CCCP011
1111111111111111111111111111111111