1111111111111111111111111111111111
1000000003100000010000001000000001
101030011000004101EC0P010040010101
1010000110101000000010004000010101
1000040000000001000000000030000001
1111111111111111111111111111111111