1111111111111111111111111111111111
1000000003100000010000001000000001
101030011000004101CE10000040010101
101000011010100P000010004000010101
1000000000000001000000000030000001
1111111111111111111111111111111111